1
***********************
*................*....*
*...........*.*...*...*
**...............**.*.*
*.**.........*.***....*
*.....*............**.*
*....**...*.*.........*
*.***...**......*.....*
*...*.*..*.*.*.**.*..**
*.*...**...***.....*..*
*.***.*.*.*...**......*
*...*.....*..*..*.....*
**.**.*.**.....**.*..**
*...**..**..**.....****
*.....**.***.*....*..**
*.*..**....*.*........*
*.**.....*..*....*.**.*
*....*...*.....**.*.*.*
*.*...*.**........***.*
*....**..*........*...*
*.............*.....***
*...*.**...*...*.*....*
***********************
