1
***********************
*.*.......*..........**
*....*.*..*.*.**.*.*..*
*.*.*.*.*...*.*...*...*
*.*..*..*.*.*.*.*...***
*.*******...*.*.***...*
*......*.**.*...*...*.*
******.**...**.***.*..*
*.......*.*.*...*.....*
*.****..*.***.*.*..**.*
*.....***...**..**...**
***.*...***..*.**.**..*
*....*.......*..*....**
*..*.*******.**....*..*
*.**...*...*..****..*.*
*....*.*.*.**.*...*...*
**.***.....*..*.*..*..*
*....*..*.*..**.*.*..**
**.*..**....*........**
*...*...*..*..**.***..*
*.*.*.*...*...*...*..**
*.....*.....*...*.....*
***********************
