1
***********************
*.*.......*..........**
*....*.*..*.*.**.*.**.*
*.*.*.*.*...*.*...**..*
*.*..*..*.*.*.*.....*.*
*.*******...*.*...*...*
*......*.**.*......**.*
******.**...**.***.*..*
*.......*.*.*...*.....*
*.****..*.***.*.*.....*
*.....***...**..**...**
***.*...***..*.**..*..*
*....*.......*..*.....*
*....*******.**.......*
*..........*..****..***
*........*.**.*...*...*
**...*.....*..*....*..*
*....*..*.*..**...*..**
*..*..*.*...*........**
*...*...*..*.....***..*
*...*.....*.....*.*..**
*...***.....*...*.....*
***********************
