1
***********************
*.....................*
*..****.************..*
*.....................*
*.**************.******
*.....................*
*****.***************.*
*.....................*
*.***************.*****
*.....................*
*****.***************.*
*.....................*
*.***************.*****
*.....................*
****.****************.*
*.....................*
*.****************.****
*.....................*
****.****************.*
*.....................*
*..**************.**..*
*.....................*
***********************
