1
***********************
*.*.......*...*...*...*
*....*.*..*.*...*.*.*.*
*.*.*.*.*...*.*.*...*.*
*.*..*..*.*.*.*.*.**..*
*.*******...*.*.*.*...*
*......*.**.*...*...*.*
******.**...**.*****..*
*.......*.*.*...*.....*
*.****..*.***.*.*.*****
*.....***...*...*.....*
***.*...***..*.******.*
*....*.......*..*.....*
*..*.*******.**....****
*.**...*...*..*.**..***
*....*.*.*.**.*...*..**
**.***.....*..*.*..*.**
*....*..*.*..**.*.*..**
**.*..**....*.*......**
*...*...*..*..******..*
*.*.*.*...*...*...*..**
*.....*.....*...*.....*
***********************
