1
***********************
*...*.*..*............*
*....*..*....*****....*
*......*.....*........*
*..*.*..*......*..*...*
*...**......***..*..***
*.*...*.*....*..*.....*
*........**....*......*
**.***.*......*..*.*..*
*.*......**..*..*.....*
*......*..*.*.....*...*
*..**...*.......**....*
*.*..*...*.*.*..*....**
**....*.......**...*..*
**....*...**....*.....*
*..**..**...**........*
*.*......**...*.*.....*
*...*.**.........*....*
*.*.*..**...***...**..*
*.*.....**...*....***.*
*...*..*..**....**....*
**.*..........*.......*
***********************
