1
***********************
*.....................*
*..****.**.*********..*
*..........*..........*
*.**********.***.*.****
*................*....*
*****.****.**********.*
*..........*..........*
*.**********.****.*****
*..........*..........*
**********.**********.*
*..........*..........*
*.**********.**********
*..........*..........*
****.*****.**********.*
*..........*..........*
*.**********.*****.****
*.....................*
****.*****.**********.*
*..........*..........*
*..*********.****.**..*
*.....................*
***********************
