1
***********************
*.....................*
*..****.**.*********..*
*..........*..........*
*.**********.***.******
*..........*..........*
*****.****.**********.*
*..........*..........*
*.**********.****.*****
*..........*..........*
*****.****.**********.*
*..........*..........*
*.**********.****.*****
*..........*..........*
****.*****.**********.*
*..........*..........*
*.**********.*****.****
*..........*..........*
****.*****.**********.*
*..........*..........*
*..**************.**..*
*.....................*
***********************
