1
***********************
*.....................*
*.....................*
*.*****.****.*****....*
*...*...*......*......*
*...*...****...*......*
*...*......*...*......*
*...*......*...*......*
*...*...****...*......*
*.....................*
********************..*
*.....................*
*.*********************
*.....................*
*********************.*
*.....................*
*.*********************
*.....................*
*********************.*
*.....................*
*.*******************.*
*.....................*
***********************
