1
***********************
*.....................*
*..*****************..*
*.....................*
*.*********************
*.....................*
*********************.*
*.....................*
*.*********************
*.....................*
*********************.*
*.....................*
*.*********************
*.....................*
*********************.*
*.....................*
*.*********************
*.....................*
*********************.*
*.....................*
*..*****************..*
*.....................*
***********************
