1
***********************
*.*.......*..........**
*....*.*..*.*.**.*.*..*
*.*.*.*.*...*.*...*...*
*.*..*..*.*.*.*.*...***
*.*******...*.*.***...*
*......*.**.*...*...*.*
******.**...**.***.*..*
*.......*.*.*...*.....*
*.****..*.***.*.*..**.*
*.....***...**..**...**
***.*...***..*.**.**..*
*....*.......*..*....**
*....*******.**....*..*
*..........*..****..*.*
*........*.**.*...*...*
**...*.....*..*....*..*
*....*..*.*..**...*..**
*..*..*.*...*........**
*...*...*..*.....***..*
*...*.....*.....*.*..**
*...***.....*...*.....*
***********************
