2
*********************************************
*...........................................*
*...........................................*
*.....................****..................*
*...*******************...**................*
*...*.......................********........*
*...*.*.*************...............*.......*
*...*...............*...............*.......*
*...*...............*.....*****.....**......*
*...*...............*.....*...*......*......*
*..**....****......**.....*...*......*......*
*..*.....*..*......*......*....*.....*......*
*..*.....*..*......*......*....*.....*......*
*..*....**..**.....*.....*.....*.....*......*
*..*....*....*....*......*.....*.....*......*
*..*....*....*....*.....**.....*.....*......*
*..*....*....*....*.....*......*.....*......*
*..**...*....*....*....*.......*.....*......*
*...*..**....*....**...*.......*.....*......*
*...*..*.....*.....*....*......*......*.....*
*...*..*.....*.....*.....**....**....*......*
*...*..*.....*.....*......*.....*....**.....*
*...*..*.....*.....*......**....*.....*.....*
*...*..*.....*.....*.......*....*.....*.....*
*..*..**.....*.....**......*....*.....*.....*
*..*..**.....*......*......**...*.....*.....*
*..*..**......*.....*.......*...*.....*.....*
*.*...**......*.....*......**...*.....*.....*
*.*...**......*.....***..**.....*.....*.....*
*.**...*......*.......****.....**.....*.....*
*..*...*......*................**.....*.....*
*..*...*......*................**.....*.....*
*..*...**.....*................*......*.....*
*...*...*.....*.........****...**.....*.....*
*...*...*.....*........**..**...*.....*.....*
*...*...*.....*........**...*...*....*......*
*...*...*.....*.........*...*...*....*......*
*...*...*.....**........*...*...*....*......*
*...**..*.....**........*...*...*....*......*
*....*..*......*.......**...*...*....*......*
*....****.....**......**....**..*****.......*
*..............********.....................*
*...........................................*
*...........................................*
*********************************************
