1
***********************
*.....................*
*.....................*
*******.****.*****....*
*...*..........*......*
*...*...****...*......*
*...*......*...*......*
*...*......*...*......*
*...*...****...*......*
*..............*......*
****************.****.*
*.....................*
*.*********************
*.....................*
*********************.*
*.....................*
*.*********************
*.....................*
*********************.*
*.....................*
*..*****************..*
*.....................*
***********************
