1
***********************
*.*...*...*...*...*...*
*.*.*.*.*.*.*...*.*.*.*
*.*.*.*.*...*.***...*.*
*...*...*.***...*.**..*
*.******....***.*.*...*
*......****.*...*...*.*
******.*....*.******..*
*......*.****...*.....*
*.****.*......*.*.*****
*.....******.*..*.....*
***.**...*...*.******.*
*......*...*.*..*.....*
*..*.*****.*.**.*..****
*.**...*...*..*.**..***
*....*.*.*.**.*...*..**
**.***.....*..***.*...*
*....*.***.*....*.***.*
**.*..*.....*.*.......*
*...*....*.*..*****.***
*.*.*.*.***...*...*...*
*.....*.....*...*.....*
***********************
