1
***********************
*.*......*...........**
*....*.*.**...**.*.**.*
*.*.*.*.....*.*...**..*
*.*..*..*.**.*......*.*
*.*******....*....*...*
*......*.**.*..*...**.*
******.**...**.*.*.*..*
*.......*.*.*..*......*
*.****..*.***...*.....*
*.....***...**...*...**
***.*...***..*.*...*..*
*....*.......**.*.*...*
*....********.*.*.....*
*..........*....*...***
*........*.**....**...*
**...*.....*.......*..*
*....*..*.*....*..*..**
*..*..*.*.....*......**
*...*...*..**..*.***..*
*...*.....*.....*.*..**
*...***.....*...*.....*
***********************
