1
***********************
*.*...*.*.*...*...*...*
*.*.*.*...*.*...*.*.*.*
*.*.*.*.*...*.***...*.*
*...*...*.***...*.**..*
*.******....***.*.*...*
*......****.*...*...*.*
******.*....*.******..*
*......*.****...*.....*
*.****.*......*.*.*****
*.....******.*..*.....*
***.**...*...*.******.*
*......*...*.*..*.....*
*..*.*****.*.**....****
*.**...*...*..*.**..***
*....*.*.*.**.*...*..**
**.***.....*..*.*..*.**
*....*.***.*..*.*.*..**
**.*..*.....*.*......**
*...*....*.*..******..*
*.*.*.*.***...*...*..**
*.....*.....*...*.....*
***********************
