1
***********************
*.....................*
*.....................*
*.*****.****.*****....*
*...*..........*......*
*...*...****...*......*
*...*..........*......*
*...*......*...*......*
*...*...****...*......*
*.....................*
****************.****.*
*.....................*
*.*********************
*.....................*
*********************.*
*.....................*
*.*********************
*.....................*
*********************.*
*.....................*
*..*****************..*
*.....................*
***********************
