1
***********************
*.*.......*...*...*...*
*....*.*..*.*...*.*.*.*
*.*.*.*.*...*.*.*...*.*
*.*..*..*.*.*.*.*.**..*
*.*******...*.*.*.*...*
*......*.**.*...*...*.*
******.**...**.*****..*
*.......*.*.*...*.....*
*.****..*.***.*.*.*****
*.....***.......*.....*
***.*...***..*.******.*
*....*.......*..*.....*
*..*.***.***.**....****
*.**...*...*..*.**..***
*....*.*.*.**.*...*..**
**.***.....*..*.*..*.**
*....*.****..**.*.*..**
**.*..*.....*.*......**
*...*....*.*..******..*
*.*.*.*.***...*...*..**
*.....*.....*...*.....*
***********************
