1
***********************
*.*.......*..........**
*....*.*..*.*.**.*.**.*
*.*.*.*.*...*.*...**..*
*.*..*..*.*.*.*.....*.*
*.*******...*.*...*...*
*......*.**.*......**.*
******.**...**.***.*..*
*.......*.*.*...*.....*
*.****..*.***.*.*.....*
*.....***...**..**...**
***.*...***..*.**..*..*
*....*.......*..*.....*
*....*******.**.*.....*
*..........*...**...***
*........*.**.....*...*
**...*.....*.......*..*
*....*..*.*.......*..**
*..*..*.*.....*......**
*...*...*..**..*.***..*
*...*.....*.....*.*..**
*...***.....*...*.....*
***********************
