1
***********************
*.*.......*..........**
*....*.*..*.*.****.*..*
*.*.*.*.*.*.*.*...*...*
*.*..*..*.*.*.*.*...***
*.*******.*.*.*.***...*
*......*..*.*...*...*.*
******.**.*.**.***.*..*
*.......*...*...*.....*
*.****..*.***.*.*..**.*
*.....***...**..**...**
***.*...***..*.**.**..*
*....*.......*..*....**
*..*.*******.**....*..*
*.**...*...*..****..*.*
*....*.*.*.**.*...*...*
**.***.....*..*.*..*..*
*....*..*.*..**.*.*..**
**.*..**....*........**
*...*...*..*..**.***..*
*.*.*.*.*.*...*...*..**
*.....*.....*...*.....*
***********************
