1
***********************
*.....................*
*.********.**********.*
*.....................*
*.***.****.*****.****.*
*.*.*.*..*.*...*.*..*.*
*.*.*.*..*.*...*.*..*.*
*.*.*.*..*.*...*.*..*.*
*.***.****.*****.****.*
*.....................*
********************..*
*.....................*
*.*********************
*.....................*
*********************.*
*.....................*
*.*********************
*.....................*
*********************.*
*.....................*
*.*******************.*
*.....................*
***********************
