1
***********************
*...*.....*...*......**
*.*.*.*.*.*.*.*.**.*..*
*.*.*.*.*...*.*...*...*
*.*...*...***.*.*...***
*.*******...*.*.***...*
*.......***.*...*...*.*
*******.*...*.****.*..*
*.......*.***...*.....*
*.*******...***.*..**.*
*......****.....**...**
******...*...*.**.**..*
*......*...*.*..*....**
*.**********.**....*..*
*..*.......*..****..*.*
*....*.***.**...*.....*
******.*...*..*.*..*..*
*....*...**..**.*.*..**
**.*..**....*........**
*...*.***..*..**.***..*
*.*.*.***.*...*...*..**
*.....*.*...*...*.....*
***********************
