1
***********************
*.....................*
*..*..................*
*..*..................*
*..*******............*
*..*..................*
*..*..................*
*.....................*
*..**...**............*
*....*.*..............*
*.....*...............*
*....*.*..............*
*..**...**............*
*.....................*
*..*..................*
*..*..................*
*..*******............*
*..*..................*
*..*..................*
*.....................*
*.....................*
*.....................*
***********************
